X XXXXXXXXXXXXXXXXXXXXXX
X       XX            XX
XX  XX   X  XX  XXXXXXXX
XX  XX  XX  XX  XX     X
XX XXXXXX  XX  XX  XXXXX
XX     XX  XX  XX  XXXXX
XX XX      XX  XX XX  XX
XX      XXXXX  XX XX  XX
XX      XXXXX  XX XX  XX
XX           XX   XX  XX
XXXXXXXXXX  XXXXXXXX  XX
XX      XX  XX  $     XX
XXXX  XX   XXXXXXXXX  XX
XX                    XX
XXXXXXXXXXXXXXXXXXXXXXXX
